############## #
#              #
#  #############
#  #           #
#  #  #######  #
#     #     #  #
#  ####  #  #  #
#  #  #  #     #
#  #  #  ####  #
#  #     #     #
######## #######
